W..........W
W..E.W.....W
W.W..W....K2
WT.W.....T.W
W..........W
W..........W
W..........W
W..........W
W..........W
W..........W
W..........W
W..........W