W..........W
W.........KW
WT.........2
W..........W
W..........W
W..........W
W..........W
W..........W
W..........W
W..........W
W..........W
W..........W