WEEEEEEEEEEW
WEEEEEEEEEK2
WEEEEEEEEEEE
WEEEEEEEEEEW
WEEEEEEEEEEW
WEEEEEEEEEEW
WEEEEEEEEEEW
WEEEEEEEEEEW
WEEEEEEEEEEW
WEEEEEEEEEEW
WEEEEEEEEEEW
WEEEEEEEEEEW