W..........W
W..E.......W
W.........K2
WT.......T.W
W..........W
W..........W
W..........W
W..........W
W..........W
W..........W
W..........W
W..........W