WEEEEEEEEEEW
WEEEEEEEEEK1
WEEEEEEEEEEE
WEEEEEEEEEEW
WEEEEEEEEEEW
WEEEEEEEEEEW
WEEEEEEEEEEW
WEEEEEEEEEEW
WEEEEEEEEEEW
WEEEEEEEEEEW
WEEEEEEEEEEW
WEEEEEEEEEEW