WWWWWWWWWWWW
WBBBBBBBBBBW
WK........BW
1.........BW
W.........BW
W.........BW
W.........BW
W.........BW
W....D....BW
W.........BW
W.........BW
WWWWWWWWWWWW