WWWWWWWWWWWW
WBBBBBBBBBBW
DEEEEEEEEEBW
EEEEEEEEEEBW
WEEEEEEEEEBW
WEEEEEEEEEBW
WEEEEEEEEEBW
WEEEEEEEEEBW
WEEEEEEEEEBW
WEEEEEEEEEBW
WEEEEEEEEEBW
WWWWWWWWWWWW