WWWWWWWWWWWW
DBBBBBBBBBBW
EEEEEEEEEEBW
WEEEEEEEEEBW
WEEEEEEEEEBW
WEEEEEEEEEBW
WEEEEEEEEEBW
WEEEEEEEEEBW
WEEEEEEEEEBW
WEEEEEEEEEBW
WEEEEEEEEEBW
WWWWWWWWWWWW