WWWWWWWWWWWW
WBBBBBBBBBBW
1EEEEEEEEEBW
EEEEEEEEEEBW
WEEEEEEEEEBW
WEEEEEEEEEBW
WEEEEEEEEEBW
WEEEEEEEEEBW
WEEEEEEEEEBW
WEEEEEEEEEBW
WEEEEEEEEEBW
WWWWWWWWWWWW