############
DBBBBBBBBBB#
EEEEEEEEEEE#
#EEEEEEEEEE#
#EEEEEEEEEE#
#EEEEEEEEEE#
#EEEEEEEEEE#
#EEEEEEEEEE#
#EEEEEEEEEE#
#EEEEEEEEEE#
#EEEEEEEEEE#
############