WWWWWWWWWWWW
WBBBBBBBBBBW
1K........BW
W.........BW
W.........BW
W.........BW
W.........BW
W.........BW
W....D....BW
W.........BW
W.........BW
WWWWWWWWWWWW