WWWWWWWWWWWW
WBBBBBBBBBBW
1KEEEEEEEEBW
EEEEEEEEEEBW
WEEEEEEEEEBW
WEEEEEEEEEBW
WEEEEEEEEEBW
WEEEEEEEEEBW
WEEEEEEEEEBW
WEEEEEEEEEBW
WEEEEEEEEEBW
WWWWWWWWWWWW