############
#BBBBBBBBBB#
#EEEEEEEEEE#
#EEEEEEEEEE#
#EEEEEEEEEE#
#EEEEEEEEEE#
#EEEEEEEEEE#
#EEEEEEEEEE#
#EEEEEEEEEE#
#EEEEEEEEEE#
#EEEEEEEEEE#
############