WWWWWWWWWWWW
WBBBBBBBBBBW
1EEEEEEEEEBW
EEEEEKEEEEBW
WEEEEEEEEEBW
WEEEEEEEEEBW
WEEEEEEEEEBW
WEEEEEEEEEBW
WEEEEEEEEEBW
WEEEEEEEEEBW
WEEEEEEEEEBW
WWWWWWWWWWWW