############
DBBBBBBBBBB#
EEEEEEEEEEB#
#EEEEEEEEEB#
#EEEEEEEEEB#
#EEEEEEEEEB#
#EEEEEEEEEB#
#EEEEEEEEEB#
#EEEEEEEEEB#
#EEEEEEEEEB#
#EEEEEEEEEB#
############